11111111111111111111
1C0000000000000000C1
10111111111111111101
101C000000000000C101
10101111111111110101
10101C00000000C10101
10101011111111010101
1010101E0100C1010101
1010101E00C100C10101
10101011111111110101
10101C0000000000C101
10101111111111111101
101C00000000000000C1
10111111111111111111
1C0000000P00000000Q1
11111111111111111111