11111111111111111111111111111
10101000001010000001010000Q11
100C0000000C00000000C0011C111
10101000C01010000001010000001
10000000000000000000000000001
10C10000010100E00000C00000001
1010100000C000000010010001011
100C0000010100000010C00010C01
1P1010000C0000000000011001011
11111111111111111111111111111